{
  "Levels": {
    "1": {
      "time": 15,
      "startPosition": {
        "x": 1,
        "y": 1
      },
      "endPosition": {
        "x": 1,
        "y": 5
      },
      "field": [
        [1, 1, 1, 1, 1, 1],
        [1, 0, 1, 0, 0, 0],
        [1, 0, 1, 0, 1, 1],
        [1, 0, 0, 0, 0, 1],
        [1, 1, 1, 1, 0, 1],
        [1, 1, 1, 1, 1, 1]
      ]
    },
    "2": {
      "time": 40,
      "startPosition": {
        "x": 1,
        "y": 1
      },
      "endPosition": {
        "x": 9,
        "y": 5
      },
      "field": [
        [1, 1, 1, 1, 1, 1, 1, 1, 1, 1, 1, 1, 1, 1, 1],
        [1, 0, 0, 0, 0, 0, 0, 0, 1, 1, 1, 1, 1, 1, 1],
        [1, 0, 1, 0, 1, 0, 1, 0, 1, 1, 0, 0, 0, 1, 1],
        [1, 0, 1, 0, 0, 0, 1, 0, 0, 0, 0, 1, 0, 1, 1],
        [1, 0, 1, 1, 1, 1, 1, 0, 1, 1, 0, 1, 0, 1, 1],
        [1, 0, 0, 1, 0, 1, 1, 0, 1, 1, 0, 1, 0, 1, 1],
        [1, 1, 0, 0, 0, 0, 0, 0, 1, 1, 0, 1, 0, 1, 1],
        [1, 1, 1, 1, 1, 1, 1, 1, 1, 1, 1, 1, 0, 1, 1],
        [1, 0, 0, 1, 1, 1, 0, 0, 0, 0, 0, 1, 0, 1, 1],
        [1, 0, 1, 0, 0, 0, 1, 1, 0, 1, 0, 1, 0, 1, 1],
        [1, 0, 1, 0, 1, 1, 1, 1, 0, 0, 0, 0, 0, 1, 1],
        [1, 0, 0, 0, 1, 1, 0, 1, 1, 1, 0, 1, 0, 1, 1],
        [1, 0, 1, 1, 0, 0, 0, 0, 0, 0, 1, 1, 0, 1, 1],
        [1, 0, 0, 0, 0, 1, 1, 0, 1, 0, 0, 0, 0, 1, 1],
        [1, 1, 1, 1, 1, 1, 1, 1, 1, 1, 1, 1, 1, 1, 1]
      ]
    }
  }
}
